11111111111111111
1C101100110N01001
101N0C00011000C01
10000C001N0000C01
10100C00NN0000CP1
1N0C01ECC0110C001
11111111111111111