11111111111111111
1C101100000C00001
10100C00000000C01
10000C00100000C01
10100C00000000CP1
100C00ECC00C0C001
11111111111111111